################
##A         ####
### ## #### ####
###  #  B   ####
################

