################
##A         ####
### ## #### ####
###  # #B#  ####
################

